+--+--+--+--+
|p    |     |
+  +--+--+  +
|  |        |
+  +--+  +  +
|     |  |  |
+--+  +  +  +
|        | g|
+--+--+--+--+
