+--+--+--+--+--+--+--+--+--+--+
|p             |              |
+  +--+  +--+  +  +--+--+--+  +
|  |  |     |     |        |  |
+  +  +--+  +--+--+--+  +--+  +
|  |     |  |        |        |
+  +  +--+  +  +--+  +  +--+--+
|     |     |  |     |     |  |
+--+  +  +--+  +  +--+--+  +  +
|  |  |        |        |     |
+  +  +--+--+--+--+--+  +--+--+
|  |           |     |        |
+  +--+--+--+  +--+  +--+--+  +
|           |        |        |
+  +  +--+--+--+--+  +  +--+  +
|  |  |              |  |  |  |
+  +--+  +--+--+--+--+  +  +  +
|        |  |        |  |     |
+  +--+--+  +  +--+  +  +  +--+
|           |  |        |    g|
+--+--+--+--+--+--+--+--+--+--+