+--+--+--+--+
|p    |    z|
+     +     +
|     |     |
+  +--+--+  +
|  |        |
+  +--+  +  +
|z    | z|zz|
+--+  +  +  +
|        | g|
+--+--+--+--+
